3 3 3 3 3 3 3 3 3 3 3 3 3 3 3 3
3 0 0 0 0 0 0 0 0 0 0 0 0 0 0 3
3 0 0 0 0 0 0 0 0 0 0 0 0 0 0 3
3 0 0 2 2 0 0 0 0 0 0 0 0 0 0 3
3 0 0 0 0 0 0 2 2 0 3 0 0 0 0 3
3 2 0 0 0 0 0 0 0 0 3 0 0 0 0 3
3 0 0 0 0 0 0 0 0 0 3 0 0 0 0 3
3 0 2 2 2 2 0 0 0 0 3 0 0 0 0 3
3 0 0 0 0 0 0 0 0 0 3 0 0 0 0 3
3 0 0 0 0 0 0 0 2 2 3 0 0 0 9 3
3 0 0 0 0 0 0 0 0 0 3 3 3 3 3 3
3 0 0 0 2 2 0 0 0 0 3 3 3 3 3 3
3 0 0 0 0 0 0 0 0 0 3 3 3 3 3 3
3 0 0 0 0 0 0 0 2 2 3 3 3 3 3 3
3 2 2 2 2 2 2 2 1 1 1 1 1 1 1 3
3 1 1 1 1 1 1 1 1 1 1 1 1 1 1 3
100 600